1111111111111111111111111111111111111111111
1000000000000000000000000000000000000000001
100101010000000000000000000000000001C101001
10011111010101010101C1C1C101010101011111001
1001111101111111111111111111111111011111001
1000111100000000000000000000000000011110001
1000011000000000000000000000000000001E10001
1000011C1000000000C1111C0000000000000010001
10100111111111111111PC111111111111111110101
1C100000000000000000000000000000000000001C1
1111111111111111111111111111111111111111111
