111111111111111111111111111111111111111111
100000000000000000000000000010001000100001
1000000000000000P000C000000010001000100001
100000000000000000000000000000100000111111
10000C00000000000E000000000C00100000000001
111111111111111111111111111111111111111111
