111111111111111111111111111111111111111111
100000000000000000000000000010001000100C01
1000000000000000P0000000000010001000100001
100000000000000000000000000000100000001111
10000E000000000000000000000C00100000000001
111111111111111111111111111111111111111111
