111111111111111111111111111111111111111111111111111111111111
111111111111111111111111111111111111111111111111111111111111
1P000000000C00000000000000C00000000000000000000C000000000111
111111111111111111111111111111111111111111111111111111110011
11C0000000000000000000000000000000000000000C0000000000011011
110011111110000000000000000000000000100000000111100001010011
110010000000000000M0000000000000000111000000010000000C110111
110010000000000000000000000000000000100000000100001111110011
110010000000000000000000000000000000000000000100000000111011
1100100000000000000011111111100000000000000001C0000000110011
110010000000000000001000000010000000000000000111100000110111
11000000000000000000101111101000000000000001110000000C110011
110000000M0000000000101E001010000000M00000000100000011111011
1100000000000000000010111010100000000000000111C0001000110011
110011100000000000001000001010000000000000000111001000100111
11000000000000000000111111101000000000000001010000100C101111
1100010000000000000000000000100000000000000101C0000001100111
110010000000000000011111111110000000000000010110000000110011
110100010000000000000000000000000000001011110100000110111011
11C000010000000000000000000000000000001000C10100000010110011
111111111111111111111111111111111111111111111111111110000111
111111111111111111111111111111111111111111111111111111111111
