11111111111111
1P0C00C00C0001
100001100000C1
10011C000M0111
100001100000C1
1E1000000C0001
11111111111111