11111111
1P0C0001
10000001
100E0001
11111111
