1111111
1000C01
10011E1
10010P1
1111111
