1111111
1000C11
10C1E01
1001CP1
1111111
